F 128,128,128
C 135,206,235

NO ./textures/brick_texture_128.xpm
SO ./textures/green.xpm
EA ./textures/blue.xpm
WE ./textures/yellow.xpm


111111111111111111111111111111111111111111111
100000000000000000011000000000000000000000001
100000000000000000011000000000000000000000001
100000000000000000011000000000000000000000001
100000000000000000000000000000000000000000001
100000000000000000011000000000000000000000001
100000000000000000011000000000000000000000001
100000000000000000011000000000000000000000001
100000000000000000011000000000000000000000001
100000000000000000011000000000000000000000001
111110011111111111111111111111111111001111111
100000000000000000011000000000000000000000001
100000000000000000011000000000000000000000001
100000000000000000011000000000000000000000001
100000000000000000011000000000000000000000001
10000000000000000001100000000000000W000000001
100000000000000000011000000000000000000000001
100000000000000000011000000000000000000000001
100000000000000000000000000000000000000000001
100000000000000000011000000000000000000000001
111111111111111111111111111111111111111111111