NO ./textures/north.xpm
SO ./textures/south.xpm
WE ./textures/west.xpm
EA ./textures/east.xpm

F 48,48,48
C 206,206,206

     11111111       111        1111111 111111111
    1000000001      101       10000000100000000011
   100111111001     101       1011111000011111100011
  10011     111     101       11     10001     110001
 1001         1     101  1111         1001       10001
1001       111      1001100001        1011        10001
1001       101      10010011001       1001         1001
1001       101      100001  1001    110001         1001
101        101      10001    1001111000111         1001
101        101      1001      1N0000000111         1001
101        101      1001      101111110001         1001
101        101      1001      1001    1001         1001
1001       101      1001      1001    1001         1001
1001       101      1001      101      101        10001
 1001      1001     1011      101     1001        1001
 10001     1001    100001    1001    10001      110001
  100011111000111110000001111000111110000111111100011
   1100000000000000010010000001000000010000000000111
     111111111111111 11 1111111111111111111111111
