SO ./textures/south.xpm
EA ./textures/east.xpm
WE ./textures/west.xpm
NO ./textures/north.xpm

F 30,56,33
C 119,181,254

11111111111111111111111111111111111111111111111111111111111111111111111111
100000000000000000000000000000000000000000000000000000000001
100000000000000000000000000000000000000000000000000000000001
100000000000000000000000000000000000000000000000000000000001
11111111000000001111111111111111100000000000111111111111111
       1000000001               1000000000001
       1000000001               1000000000001
       1000000001               10000000000011
11111110000000001111111111111111100000000000111111111111111111111111  11111111
10000000000000000000000000000000000000000000000000000000000000000001 10011111
100000000000000000000000000000000000000000000000000000000000000000001000000001
100000000000000000000000000000E0000000000000000000001111100000000000000000111
10000000000000000000000011000000000000000000000000000011110000000000000000011
100000000000000000000000000000000000000000000000000011011000000000000000001
100000000000000000000000000000000000000000000000000011111000000000000000011
1000000000000000000000000000000000000000000000000000000000000000000000001
100000001111111111111111111111111111111111111111111111111111111111111111111
10000001
10000001
10000001
10000001
10000001
10000001
11111111
10000001
10000001
10000001
10000000111111111
11111111111111111
